1111111111111111111111111111111
100000000100000000000C000100001
10000PC001000000000000000001001
1000000000000010C00000C00111111
100000C001001C00000E00000100001
100000000101000000000C000000001
1000000C0000000C000000C00C00001
1111111111111111111111111111111